24 25
1111111111111111111111111
0001000110001110000000001
1010010010101110101111111
1010111010100100101111111
1010111010110001100000001
1010010010111111101111111
1011010110111111101111111
0000010000111111100000001
1111111111111111111111001
1000000000000000000000001
1001111111111111111111001
1001111111111111111111001
1001111111111111111111001
1001110000111000011111001
1001100110010011001111001
1001100111000111001111001
1001110011111110011111001
1001111001111100111111001
1001111100111001111111001
1001111110011000000011001
1001111111001111111111001
1000000000000000000000001
1000000000000000000000001
1111111111111111111111111
1 0
19 19