15 14
11111111111111
11000100010001
00010101010101
11110101010101
11110101010101
11110101010101
11110101010101
00000101010101
11010101010101
11000101010101
11110101010101
11110001000101
11111111111101
10000000000001
10111111111111
2 0
14 1
