20 19
1111111111111111111
0000000000000000001
1111111111111111101
1000000000000000101
1011111111111110101
1010000000000010101
1010111111111010101
1010100000001010101
1010101111101010101
1010101000101010101
1010101000101010101
1010101000101010101
1010101000001010101
1010101111111010101
1010100000000010101
1010111111111110101
1010000000000000101
1011111111111111101
1000000000000000001
1111111111111111111
1 0
10 8