43 43
1111111111111111111110111111111111111111111
1000001000000010000000000000000010100000101
1010101011111010111111111111011110101010101
1010101000100010000010000010001010001010101
1010101110111111111010111011101011111010101
1010100010100000101000100010101000000010101
1010111010101010101111101110101111111110101
1010100010001010000010001000100010000010101
1110101111111011111110111010111011111010101
1000100010001000000010100010100010000010101
1011111010101111111010101110101110111110101
1000100000100000000010001000101000000010001
1010111111111110111111111011101111101011101
1010100000001000100000001010001000101010001
1110101111101110101110111010111010111010111
1000100000100010101010000010000010001000101
1011111110111011101011111111111111101011101
1000000010101000001000000000000010001010001
1111111010101111111110111111111110111010111
1000001010000000100010100000100010101010001
1011101011111110101010101110101010101010101
1010101000000010001010000010101000100010101
1010101011101111111011111110101111101111101
1010101010001000001000100000101000001000001
1010101110111011101110101011101111101011101
1010000010000000101000001010001000100010001
1011111011111111101011111110111010111110111
1000100000000010001010000000100010001010001
1010111111111010111010111110101111101011101
1010100000100000100010100000100010001000001
1010101110111111101110111011111010111111101
1010000010000000000010001000101010000000101
1011111111111011111111101110101011111110111
1000100000001010000010001000001000001010001
1110101111101110111010111111111011101011101
1000101000100010100000100000001000101000101
1011101110111010111011101111101111101010101
1010100010000010001010101000100000001010001
1010111011101111101010101011111111111011111
1000101000100000001010001000001000001010001
1110101110111111111111111010111011101011101
1000000010000000000000000010000000100000001
1111111111111111111110111111111111111111111
42 21
0  21
